11 25
|=======================|
|**!**|=|***&***|=|**!**|
|*|=|*|=|*|===|*|=|*|=|*|
|*|=|*******&*******|=|*|
|*|=|*|=|*|===|*|=|*|=|*|
|&********|*!*|********&|
|*|=|*|=|*|*=*|*|=|*|=|*|
|*|=|*******&*******|=|*|
|*|=|*|=|*|===|*|=|*|=|*|
|@*!**|=|***!***|=|**!**|
|=======================|